
 	 	 	  NO textures/NorthTexture.xpm
  SO   	 	 	  textures/SouthTexture.xpm
					   WE textures/WestTexture.xpm
	 	   EA textures/EasthTexture.xpm

F 0,255,0
C 10,0,250

111111111111111111111111111111111
1	    1000000000110000001000S01
1		1011000001110000001000011
1   	1001000000000000001111D11
111111111011000011100000000000011
100000000000000000000000000011111
10000000000000000000000000001
10000000000000000000000000001
10000000000001000000000000001
10000000000000000000000000001
100000000000000D0000000000001
11000001110101011111011110111
11110111 1110101 1000111010001
11111111 1111111 1111111111111