
 	 	 	  NO textures/NorthTexture.xpm
  SO   	 	 	  textures/SouthTexture.xpm
					   WE textures/WestTexture.xpm
	 	   EA textures/EasthTexture.xpm

F 61,32,1
C 0,185,222 

        1111111111111111111111111
        1000000000110000000000N01
        1011000001110000000000001 
        100100000000000000000000011
111111111011000011100000000000011
100000000000000000000000000011111
10000000000000000000000000001
10000000000000000000000000001
10000000000001000000000000001
10000000000000000000000000001
10000000000000000000000000001
11000001110101011111011110111
11110111 1110101 1000111010001
11111111 1111111 1111111111111